The Weeknd - Save Your Tears
Dua Lipa - Don't Start Now
Harry Styles - Watermelon Sugar
Bruno Mars & Anderson .Paak - Leave the Door Open
Miley Cyrus - Flowers
Justin Timberlake - Mirrors
Ed Sheeran - Shape of You
Maroon 5 - Sugar
The Killers - When You Were Young
Coldplay - Viva La Vida
Imagine Dragons - Radioactive
The 1975 - The Sound
Portugal. The Man - Feel It Still
MGMT - Electric Feel
Foster the People - Pumped Up Kicks
Arctic Monkeys - Do I Wanna Know?
Franz Ferdinand - Take Me Out
The Black Keys - Gold on the Ceiling
Kings of Leon - Sex on Fire
Foo Fighters - The Pretender
Red Hot Chili Peppers - Can't Stop
Blink-182 - All the Small Things
Green Day - Holiday
Fall Out Boy - Dance, Dance
Paramore - Misery Business
Panic! At The Disco - I Write Sins Not Tragedies
OutKast - Hey Ya!
Kanye West - Stronger
Jay-Z & Alicia Keys - Empire State of Mind
Drake - Headlines
Kendrick Lamar - HUMBLE.
Travis Scott - Goosebumps
Post Malone - Wow.
Childish Gambino - 3005
Anderson .Paak - Am I Wrong (feat. ScHoolboy Q)
Frank Ocean - Pink + White
Miguel - Sky Walker
SZA - Kill Bill
The Weeknd - Can't Feel My Face
Rihanna - Diamonds
Beyonce - Love On Top
Lizzo - About Damn Time
Doja Cat - Say So
Sam Smith - Unholy
Calvin Harris & Rihanna - This Is What You Came For
David Guetta & Sia - Titanium
Zedd & Alessia Cara - Stay
Kygo & Selena Gomez - It Ain't Me
Avicii - Levels
Swedish House Mafia - One (Your Name)
Deadmau5 - Ghosts 'n' Stuff
Tiesto - The Business
Fred again.. - adore u
Rufus Du Sol - Innerbloom
ODESZA - Behind the Sun
Disclosure - Latch (feat. Sam Smith)
Jessie Ware - Free Yourself
Robyn - Dancing On My Own
Lady Gaga - Poker Face
Kesha - Die Young
Katy Perry - The One That Got Away
Kelly Clarkson - Since U Been Gone
P!nk - So What
Christina Aguilera - Ain't No Other Man
Gwen Stefani - Hollaback Girl
Justin Timberlake - SexyBack
Nelly Furtado - Promiscuous
Timbaland - The Way I Are
Akon - Smack That
T-Pain - Buy U a Drank
Ne-Yo - Miss Independent
Usher - Yeah!
Chris Brown - Forever
Rihanna - Don't Stop the Music
Beyonce - Crazy in Love
Black Eyed Peas - I Gotta Feeling
Pitbull - Give Me Everything (feat. Ne-Yo)
Flo Rida - Good Feeling
David Guetta - Memories (feat. Kid Cudi)
LMFAO - Party Rock Anthem
Maroon 5 - Moves Like Jagger
Train - Drive By
Jason Mraz - I'm Yours
Jack Johnson - Upside Down
John Mayer - New Light
Ed Sheeran - Perfect
Lewis Capaldi - Forget Me
Adele - Rolling in the Deep
Hozier - Take Me to Church
Lorde - Green Light
Florence + The Machine - Dog Days Are Over
Lana Del Rey - Summertime Sadness (Remix)
Noah Kahan - Stick Season
Zach Bryan - I Remember Everything
Morgan Wallen - Whiskey Glasses
Chris Stapleton - Tennessee Whiskey
Luke Combs - Fast Car
Kelsea Ballerini - Mountain with a View
Tyler Childers - Feathered Indians
Brothers Osborne - It Ain't My Fault
Eric Church - Springsteen
Dierks Bentley - Sideways
Old Dominion - Snapback
Thomas Rhett - Life Changes
Dan + Shay - 19 You + Me
Sam Hunt - House Party
Florida Georgia Line - Cruise
Kenny Chesney - American Kids
Shania Twain - Man! I Feel Like a Woman!
Carrie Underwood - Before He Cheats
Luke Bryan - Country Girl (Shake It for Me)
Keith Urban - Somebody Like You
Rascal Flatts - Life Is a Highway
Tim McGraw - Something Like That
Matchbox Twenty - How Far We've Come
Goo Goo Dolls - Slide
Counting Crows - Accidentally in Love
Train - Hey, Soul Sister
OneRepublic - Counting Stars
Coldplay - A Sky Full of Stars
Leon Bridges - Smooth Sailin'
Vance Joy - Mess Is Mine
Ben Rector - Living My Best Life
Dermot Kennedy - Something to Someone
James Bay - Let It Go
Allen Stone - Consider Me
Anderson East - All on My Mind
Johnnyswim - Home
Ray LaMontagne - You Are the Best Thing
Amos Lee - Windows Are Rolled Down
Nathaniel Rateliff & The Night Sweats - You Worry Me
The Revivalists - Wish I Knew You
Kaleo - Way Down We Go
Rag'n'Bone Man - Human
Matt Maeson - Hallucinogenics
Barns Courtney - Fire
Welshly Arms - Legendary
The Struts - Could Have Been Me
Greta Van Fleet - Safari Song
Imagine Dragons - Whatever It Takes (Acoustic)
Bastille - survivin'
CHVRCHES - Miracle
M83 - Midnight City
Empire of the Sun - We Are the People
Bob Moses - Love Brand New
Lane 8 - Reviver
Elderbrook - Howl
SG Lewis - Missing You
Roosevelt - Strangers
Jungle - Back on 74
Parcels - Lightenup
Tom Misch - It Runs Through Me
Mac Ayres - Easy
Masego - Passport
Cautious Clay - Wildfire
Snoh Aalegra - I Want You Around
H.E.R. - Focus
Daniel Caesar - Get You
Giveon - Heartbreak Anniversary
Brent Faiyaz - Dead Man Walking
Miguel - Pineapple Skies
Anderson .Paak - Make It Better
Childish Gambino - Feels Like Summer
Rex Orange County - Loving Is Easy
Dominic Fike - Politics & Violence
Dayglow - Hot Rod
Coin - Malibu 1992
Valley - Oh Shit... Are We in Love?
The Japanese House - Boyhood
Phoebe Bridgers - Kyoto
Maggie Rogers - Alaska
Clairo - Sofia
HAIM - The Steps
Lizzy McAlpine - All My Ghosts
Ashe - Angry Woman
Laufey - Let You Break My Heart Again
YEBBA - Boomerang
Lianne La Havas - Can't Fight
Norah Jones - Sunrise
Jason Isbell - If We Were Vampires
Brandi Carlile - The Story
Marcus King - Good and Gone
Chris Stapleton - Cold
Brothers Osborne - Skeletons
Midland - Longneck Way to Go
Parker McCollum - Handle on You
Zach Top - Sounds Like the Radio
Hailey Whitters - Plain Jane
Caitlyn Smith - High
Caamp - By and By
Mt. Joy - Lemon Tree
The Brook & The Bluff - Halfway Up
Rainbow Kitten Surprise - It's Called: Freefall
Hippo Campus - Buttercup
Peach Pit - Tommy's Party
Men I Trust - Billie Toppy
Men I Trust - Show Me How
Novo Amor - Anchor
Bon Iver - Holocene
The Paper Kites - Electric Indigo
