Dua Lipa – Don’t Start Now
The Weeknd – Blinding Lights
Lizzo – Good As Hell
Justin Timberlake – Can’t Stop the Feeling!
Bruno Mars – 24K Magic
Mark Ronson ft. Bruno Mars – Uptown Funk
Harry Styles – As It Was
Dua Lipa – Levitating
Lady Gaga – Rain On Me
Ariana Grande – No Tears Left to Cry
Shakira – Hips Don’t Lie
Taylor Swift – Shake It Off
Pharrell Williams – Happy
Kygo & Whitney Houston – Higher Love
Calvin Harris ft. Dua Lipa – One Kiss
David Guetta ft. Bebe Rexha – I’m Good (Blue)
Pink – Trustfall
Ellie Goulding – Love Me Like You Do
Jonas Brothers – What a Man Gotta Do
Tones and I – Dance Monkey
Walk the Moon – Shut Up and Dance
DNCE – Cake by the Ocean
Jess Glynne – Hold My Hand
Carly Rae Jepsen – Call Me Maybe
Coldplay – A Sky Full of Stars
Maroon 5 – Sugar
Ava Max – Maybe You’re the Problem
The 1975 – It’s Not Living (If It’s Not with You)
Sia – Cheap Thrills
Zara Larsson – Can’t Tame Her
Paramore – Ain’t It Fun
Imagine Dragons – On Top of the World
The Killers – Mr. Brightside
Coldplay – Adventure of a Lifetime
Owl City – Fireflies
Post Malone – Circles
P!nk – Raise Your Glass
Shawn Mendes – There’s Nothing Holdin’ Me Back
Marshmello & Bastille – Happier
Clean Bandit ft. Jess Glynne – Rather Be
Avicii – Wake Me Up
Swedish House Mafia – Don’t You Worry Child
Sigala – Sweet Lovin’
David Guetta ft. Sia – Titanium
Justin Bieber – Sorry
Pitbull ft. Ne-Yo – Give Me Everything
OneRepublic – Run
Kelly Clarkson – Stronger (What Doesn’t Kill You)
Miley Cyrus – Flowers
Troye Sivan – Rush
Kylie Minogue – Padam Padam
Becky Hill – Remember
Tate McRae – Greedy
The Chainsmokers – Closer
Ed Sheeran – Shivers
Lady Gaga – Poker Face
Ariana Grande – Break Free
Sigala & Ella Eyre – Came Here for Love
Charlie Puth – Attention
Sabrina Carpenter – Espresso
Portugal. The Man – Feel It Still
BØRNS – Electric Love
Foster the People – Sit Next to Me
Glass Animals – Heat Waves
The Neighbourhood – Sweater Weather
COIN – Talk Too Much
Saint Motel – My Type
Two Door Cinema Club – What You Know
The Lumineers – Cleopatra
Of Monsters and Men – Little Talks
The Head and the Heart – Rivers and Roads
M83 – Midnight City
Dayglow – Can I Call You Tonight?
Empire of the Sun – Walking on a Dream
Phoenix – Lisztomania
Vampire Weekend – A-Punk
The Wombats – Greek Tragedy
MGMT – Electric Feel
Paramore – Still Into You
Young the Giant – Cough Syrup
Arctic Monkeys – Snap Out of It
Matt and Kim – Daylight
Milky Chance – Stolen Dance
Fitz and the Tantrums – HandClap
CHVRCHES – The Mother We Share
Alt-J – Breezeblocks
Grouplove – Tongue Tied
Cage the Elephant – Come a Little Closer
The Strumbellas – Spirits
Bleachers – Don’t Take the Money
The Japanese House – Sunshine Baby
RÜFÜS DU SOL – Treat You Better
Vance Joy – Riptide
Bastille – Pompeii
Tame Impala – The Less I Know the Better
Florence + the Machine – Dog Days Are Over
LANY – ILYSB
KALEO – Way Down We Go
The Temper Trap – Sweet Disposition
Noah Kahan – Dial Drunk
Earth, Wind & Fire – September
Prince – Kiss
Michael Jackson – P.Y.T. (Pretty Young Thing)
Whitney Houston – I Wanna Dance with Somebody
Stevie Wonder – Superstition
Fleetwood Mac – Everywhere
Queen – Don’t Stop Me Now
ABBA – Gimme! Gimme! Gimme!
Hall & Oates – You Make My Dreams
Journey – Don’t Stop Believin’
Bee Gees – Stayin’ Alive
OutKast – Hey Ya!
Destiny’s Child – Jumpin’, Jumpin’
Backstreet Boys – Everybody (Backstreet’s Back)
Britney Spears – Toxic
NSYNC – Bye Bye Bye
Christina Aguilera – Come On Over Baby
Gwen Stefani – Hollaback Girl
Maroon 5 – Moves Like Jagger
Sheryl Crow – Soak Up the Sun
Third Eye Blind – Semi-Charmed Life
Smash Mouth – All Star
Sugar Ray – Every Morning
Red Hot Chili Peppers – Can’t Stop
No Doubt – Just a Girl
Blink-182 – All the Small Things
Green Day – Good Riddance (Time of Your Life)
Jimmy Eat World – The Middle
Paramore – Misery Business
Foo Fighters – Learn to Fly
Coldplay – Viva La Vida
Gotye ft. Kimbra – Somebody That I Used to Know
Daft Punk – Get Lucky
Gnarls Barkley – Crazy
OutKast – Roses
Alicia Keys – No One
Amy Winehouse – Valerie
Jason Mraz – I’m Yours
Train – Hey, Soul Sister
Jack Johnson – Upside Down
OutKast – The Way You Move
Dr. Dre ft. Snoop Dogg – The Next Episode (clean)
Missy Elliott – Lose Control
Macklemore & Ryan Lewis – Can’t Hold Us
Post Malone – Wow.
Lizzo – About Damn Time
Anderson .Paak – Come Down
Doja Cat – Say So
Jack Harlow – First Class
Megan Thee Stallion – Body (clean)
Saweetie – Best Friend (clean)
Coi Leray – Players
Nelly – Ride wit Me
Kanye West – Stronger (clean)
Kid Cudi – Day ’n’ Nite
OutKast – So Fresh, So Clean
Snoop Dogg – Drop It Like It’s Hot (clean)
Pharrell – Frontin’
Usher – Yeah!
Beyoncé – CUFF IT
Rihanna – We Found Love
The Black Eyed Peas – I Gotta Feeling
Drake – Hold On, We’re Going Home
Childish Gambino – 3005
Tyler The Creator – See You Again
Khalid – Talk
SZA – Snooze
Frank Ocean – Pink + White
The Weeknd – Starboy
Anderson .Paak & Bruno Mars – Leave the Door Open
Zach Bryan – Something in the Orange
Morgan Wallen – Last Night
Luke Combs – Beautiful Crazy
Kacey Musgraves – High Horse
Chris Stapleton – Tennessee Whiskey
Thomas Rhett – Die a Happy Man
Brothers Osborne – It Ain’t My Fault
Jon Pardi – Head Over Boots
Luke Bryan – Play It Again
Old Dominion – Snapback
Maren Morris – The Bones
Dan + Shay – Speechless
Sam Hunt – House Party
Bailey Zimmerman – Religiously
Midland – Drinkin’ Problem
Cody Johnson – Till You Can’t
Jelly Roll – Need a Favor
Carrie Underwood – Before He Cheats
Blake Shelton – Honey Bee
Shania Twain – Man! I Feel Like a Woman!
Keith Urban – Somebody Like You
Florida Georgia Line – Cruise
Eric Church – Springsteen
Little Big Town – Pontoon
Lainey Wilson – Watermelon Moonshine
Kenny Chesney – American Kids
Breland – Cross Country
Darius Rucker – Wagon Wheel
Beyoncé – TEXAS HOLD ’EM
Post Malone ft. Morgan Wallen – I Had Some Help